3333333333333
3001111110003
3032323232303
3012111112103
3132323232313
3112111112113
3132323232313
3112111112113
3132323232313
3012111112103
3032323232303
3000111110003
3333333333333