333333333
300000003
300000003
303333303
303333303
303333303
303333303
300000003
333333333