3333333333333
3000111110003
3030323232303
3010000000003
3130323232313
3110111112113
3130323232313
3110111112113
3130323232313
3010111112103
3030323232303
3000111110003
3333333333333