3333333333333
3000000000003
3030303030303
3000000000003
3030303030303
3000000000003
3030303030303
3000000000003
3030303030303
3000000000003
3030303030303
3000000000003
3333333333333