3333333333333
3000001000003
3030323230303
3000001000003
3030323230303
3000001000003
3030323230303
3000001000003
3030323230303
3000001000003
3030323230303
3000001000003
3333333333333