3333333333333
3000011100003
3030323230303
3000011100003
3030323230303
3000011100003
3030323230303
3000011100003
3030323230303
3000011100003
3030323230303
3000011100003
3333333333333